#################################################################
#                        #                                      #
#   S                    #                                      #
#                        #           #                          #
#                                    #                          #
###########################################                     #
#                                                               #
#                                                               #
#                                                               #
#                                      #########                #
#                                        #                      #
###########################              #                      #
#                 #                      #                      #
#                 #                                             #
#                 #                 ####################        #
#                 #                      #             #        #
#                 #                      #             #        #
#                                                      #        #
#                                                      ##########
#     ########################################                  #
#                                                               #
#                                                               #
#                                                               #
#                                                   E           #
#                                                               #
#################################################################