....................................................................................................
.                                                                                                  .  
.     S                                                                                            .  
.                                                                                                  .  
.                                                                                                  .  
.                                                                                                  .  
.                   .....................................................                          .  
.                                                                                                  .  
.                                                                                                  .  
.                                                                                                  .  
.                                                                                                  .  
.                                                                                                  .  
.                                                                                                  .  
.                                                                                                  .  
.                                                                                                  .  
.      .......................................................                                     .  
.                                                    .                                             .  
.                                                    .                                             .  
.                                                    .                                             .  
.                                                    .                 ....................        .  
.                                                    .                                    .        .  
.                                                    .                                    .        .  
.                                                                                         .        .  
.                                                                                         ..........  
.                               .................................................                  .  
.                                                                                                  .  
.                                                                                                  .  
.                                                                                                  .  
.                                                                                                  .  
.                                                                                      E           .  
.                                                                                                  .  
.                                                                                                  .  
.                                                                                                  .  
.                                                                                                  .  
....................................................................................................