#################################################################
#                        #                                      #  
#   S                    #                                      #  
#                        #           #                          #  
#                                    #                          #  
######################################                          #  
#                                                               #  
#                                                               #  
#                                                               #  
#                                                               #  
#                                                               #  
###########################                                     #  
#                 #                                             #  
#                 #                                             #  
#                 #                 ####################        #  
#                 #                                    #        #  
#                 #                                    #        #  
#                                                      #        #  
#                                                      ##########  
#     ########################################                  #  
#                                                               #  
#                                                               #  
#                                                               #  
#                                                   E           #  
#                                                               #  
#################################################################
